1x11111111111111111111111111111
1010101000100010001000100000101
1010101110101111101011101011101
1000100000000010100000001000001
1011101010111110111110101111111
1010101010100000001010100010001
1010101011101011111011101111101
1000001010001000001000001010101
1110111111101011101010101010101
1000001000001000100010100000001
1011111110111111111011101110101
1000000010001000001010001000101
1011111010111011111110101010101
1000100010000010000010101010101
1111111010111111111011101110111
1010101000100010101010001010001
1010101011101110101011101011111
1000000010000010000010001010001
1011111110111110101110101010111
1010000000101000101000100000001
1010101111101011101110111111101
1000101000000010000000000000101
11111111111111111111111111111y1
