1x11111111111111111111111111111111111111111
1000001000101000101000100010101000000010001
1010111110101011101011111010101010111011101
1010100000001000100010100000100010100000001
1110111110101010101010101111101011111110101
1010100000100010101000001000101010100010101
1010101011111011101011101110111110101110101
1010001010000000101010000010100010101000101
1010111011111110111110111110101010101011101
1000101010101000100010100000101000000000101
1111101010101111101010101011101110111011101
1000001000000010001000001010001000100000101
1010111010111110101011111111111011111110111
1010000010101010101000000010100010100010001
1011101010101011101110101010111010101110101
1010001010001000001000101000100000001000101
1111111011101010111011101111111011111110111
1000001000100010100010000010101000101000001
1010111111111111111111111010101110101111101
1010001000000010000010001000000000000000101
1010111110111010111110101011101010101011101
1010001010101000001000101000101010101010101
1111101011101110101010111010111111101110101
1010100000100010100010101010001010001010001
1010101110101110101110101011111010101010111
1000000010100010100010000000100000100010001
1011101110101110101011111110111111111111101
1010001000000010101000100000001000000000101
1111111011101111111110111011111111101011101
1000100000100000000000101000001010001000101
1110101010111011101111101011111010101110111
1000001010100000100000100000000000100010001
11111111111111111111111111111111111111111y1
