###################################
#11111x111111111111111111111111111#
#100000000000101000000000001010001#
#101110111011101010101110111010111#
#100010100010001010101000000010001#
#101110101110101010101011101111101#
#101000101010101010101000100000001#
#111111101010101010101111101111101#
#100000001000101010101010101010001#
#111110101110111111101010111010101#
#101010100000101000001010001010101#
#101011111011101110111010101010111#
#101010000000100000001000100000001#
#101010111011111111101110111111101#
#100000001000001010001010001000001#
#111011111111101011111011111110101#
#100010001000001000000010000000101#
#101111101111101011111110111011111#
#101000001000101000000000001000001#
#101010111011111010111011111111111#
#100010100010001010101000101010101#
#111010101110111011101110101010101#
#100010100000001000100010101000101#
#101111111011111111101010101110101#
#100000000000000000001000000000001#
#1111111111111111111111111111111y1#
###################################