#################################
#11111x1111111111111111111111111#
#1010000010000010100000101010001#
#1010111111111010111011101010101#
#1000100010100000001010100010101#
#1010101110111111101010101010101#
#1010000010001000101000101000101#
#1110101110111011101110111010111#
#1000100000001000100000000010101#
#1110111111111110111110101010101#
#1000101000001000001000101010001#
#1010101111101110101011101111101#
#1010000000101000101010101010001#
#1011101110101110101110101011111#
#1010100010000000100000000000001#
#1010101111111110111111101111111#
#1010100010101010100000100010101#
#1010111110101011111110101010101#
#1010100000000010100010001010001#
#1010101111111010101110111010111#
#1000100010000000100010001000001#
#1110101111111011101011101111101#
#1000000010000000101000000010001#
#11111111y1111111111111111111111#
#################################