###################################
#111111111111111111x11111111111111#
#101000100010000000000010000010001#
#101010111011111010111010111111101#
#101010000010100010001010001000101#
#101011101110101011101010101110101#
#100010101000101010101010101000001#
#101110111110101010111011101110101#
#100010000010001010101000101000101#
#101010111110111010101011101011111#
#101010000000100000101000100000001#
#101111111011111011101111101111111#
#100000000010000010000000100010101#
#101010101011101110111110101110101#
#101010101000100000001010100000001#
#101110101111101010111011101011101#
#100010101000101010001010101010001#
#101110111110101011111010101111111#
#101010101000101000000000100010001#
#111010101010101111111010101110111#
#100000000010100010000010000000101#
#111111101111111011111011111010101#
#100000001010100000101010100010001#
#101111101010101010101110111111101#
#101000000000101010001000000000011#
#11111111y111111111111111111111111#
###################################