###################################
#111111111111111111111111111111111#
#100x00000010100000001000001000001#
#111010111110101111101110111110101#
#100010001000101010000010101010101#
#101011111011101010101110101011101#
#101010000010001000100000001000001#
#111010101111101011101110111111101#
#101000100000101000101010000000001#
#101011101110101110111011101110111#
#101010100010100010101010101010101#
#101010101111111010101010111011101#
#101010000010000010001000001000101#
#101011111111101111111010111010101#
#100010001000100000100010000010001#
#111011101011111010101011101010101#
#100000001000100010001010101010101#
#101110111011101111111010111110101#
#101000000000000010001010000000101#
#101011111111101010111111101111101#
#101000100010001010001010001000101#
#101111111010111110101010111011111#
#100010001010000000101010001010101#
#101010111011111010111010111010101#
#101010000000000010001000000000001#
#1111111111111111111y1111111111111#
###################################