#################################
#1111111111111111111111111111x11#
#1010000010001000000000000000001#
#1010111110101011111011111110111#
#1000101000101010000010000000001#
#1110101110101011111011101111101#
#1000000010101000101010001010101#
#1110101110111111101011101010111#
#1000101000001000000010000010001#
#1110101011111111101111111111101#
#1000100000000010001010000010101#
#1011101111111010101010111010101#
#1000100000001000101000001010001#
#1010101111101010101111111010101#
#1010101000101010101010000000101#
#1010111011111111101011101111101#
#1010100000101000000000001010101#
#1011101011101011101110111010101#
#1010101000000000100010001000001#
#1110101110111111101011101110111#
#1000000010001010101000100010101#
#1011101011101010101110111010101#
#100010y000100000101000001010001#
#1111111111111111111111111111111#
#################################