###################################
#11111111111111x111111111111111111#
#101010000010100000100000000000001#
#101011101110111110101011111110101#
#100000100000101010001010000010101#
#101111101111101011111111111011101#
#101010001000100000100000000010001#
#101011101110111010101011111010111#
#101000000000100010001000101000001#
#101111101010111111111111101110111#
#101010001010101000100010001000001#
#101010111111101011111010101011111#
#101000100000001000000010100010101#
#101010111010101110111011101010101#
#100010100010101000101000001000001#
#101011101110111011101111111110111#
#101000101000001010000000000000001#
#111011111011101011111010111110111#
#101000001000100010001010000010101#
#101011101111101010111011101110101#
#100010000010001000100010000010001#
#101011111111111010111111101111101#
#101010101000100010000000101000101#
#101110101011101010111011101011111#
#100000000000001010001010000000001#
#111111111111111111111111y11111111#
###################################