1x11111111111111111111111111111111111111111111111
1010100010101000001010100010101010101000100010001
1010101110101011111010111010101010101010101111101
1000100000100000000000000010000000100010100000001
1110101110111111101111111110111011111011111110111
1010100010000010000010100010100000001000000010001
1010111110101110111110101011111011111011111010101
1000001000101000001000101010000000101010000010101
1011111110111011101110101110111011101011111010111
1000100000001000101010000000100000001000001010001
1011101111101010101010101111111110111110101011101
1000001000100010100010101000001010100010101000001
1010111010101111111111101011101011101110101111111
1010100010100010000000000010001010101000101000001
1011111011101111101111101011101010101111101111101
1000100010001010001010001000101010001000101000001
1110101010101011101011111011101011101010101111101
1000001010100000100010000000100000000010100010101
1110111010111010101010111111111011101110101010101
1000001010101010101010100000100010000010001010001
1110101111101110101011111110101010111011111010111
1000101000001000101000100010001010001010101000001
1011101010111011101110111010111111111110101011101
1000100010100000101010100000000010100010000000101
1011111110101111111011111011101110111011101111101
1000000010101000100000000010100000100010101010001
1010101110111110111110101110111111111010101010111
1010101000001000001010101000000000001000101000001
1111111010101110111010101011101111101010111110111
1000001010101000001010101010000010101010100000101
1010111111101111101011111010101010111010111010101
1010100000000000101010001010101000000010100010101
1110101110101111101010101011111110101011111010101
1010001000100000000000100010100010101000001010101
1010111110111111101111111010101011111011101110101
1000000010001000000000100000001000100000100000001
11111111111111111111111111111111111111111111111y1
