#################################
#1111111111111111111111111111111#
#1000000000001001000001000000001#
#1111001001111001111001001001111#
#1001001001001000000000001000001#
#1001001111001001001111111111001#
#1000000000001001000000001000001#
#1001111001111001001111111111001#
#1001000000000001001000000001001#
#1001111111111111001001001111111#
#1000000000001000001001000001001#
#111111111111100111111x001111001#
#1000000000000000001000000001001#
#1111111001111001001001111111001#
#1000001000001001000001000000001#
#1001111001111001111111111111001#
#1000000000001001001000000000001#
#1111111001001111001111001111001#
#1000000001001000001000001001001#
#1111001001111001111111001001111#
#1001001000001000000000000000001#
#1001001111001001111111001111001#
#100000y100000000000000100000101#
#1111111111111111111111111111111#
#################################