1x111111111111111111111111111111111
10001010001010001010101010100010001
11101010101010101010101010111010111
10000000100000101000101010000000001
10111111101111101110101011101010111
10101000000010100010001010001010101
11101011111010101010101010101111101
10001010000000101000101000100010001
10101111111111111110101011111011101
10101000001000000000100010001010101
10101011111111111111111110111010101
10101000100000100000000010000010001
10111110101110111011111011111011101
10001010001000000000101000001010101
10111010111110111110101010111010101
10000000001010001010001010101000001
10111110101011101011101110101010111
10001000101000101000101000000010001
10111111111110101110101110101111101
10001000101000000000101000101010001
11101011101011101010111110101010111
10001010100010001010100000101000001
10111010111110111110111110111111111
10100000100010100010100000100010001
10111011101010111010111110101111101
10100000001000100000000010000000001
111111111111111111111111111111111y1
