###################################
#1111111x1111111111111111111111111#
#100010000000100010100000000010001#
#101011101011101010101111111110101#
#101000001010001000101000100010101#
#101110111010111110101110111010101#
#101010001000100000100010000010101#
#111010111110101011111010101111101#
#101000001000101000001000101000101#
#101010111010111010111110111110101#
#100010100010101010000000101000101#
#111111111111101011101111101110101#
#100000000010101000101000001000001#
#111110111010101110111111101110111#
#101010100010100010101000001000101#
#101010111010111010101011111010101#
#101000100000100000100010100010001#
#101011111011101010101110101011111#
#100000100000101010000000001010001#
#111111111110101011111011101110101#
#101000000010001000001010000000101#
#101011111010111011111111111011101#
#100000001010101000100000100000101#
#101010111110101110111110101011111#
#101010000000000010001000001000001#
#11111111111111111y111111111111111#
###################################