#################################
#111111x111111111111111111111111#
#1000000000100010000000000000101#
#1111101011101011101111111011101#
#1000001010001010100010100000001#
#1011111010101110111010101111101#
#1000001000100000101010101000101#
#1111111111101111101110101110111#
#1000000000101010100010001000001#
#1011111110101010111011101110101#
#1010000010001010100000000000101#
#1011101010111010101110111011111#
#1010101000101000000010001000001#
#1010111010101111101111101010101#
#1010000010001000000010001010101#
#1111111110101011111011101010101#
#1010001000101000001000101010101#
#1010111110101111111011111110111#
#1000001000100010000010000000001#
#1110101111111010111011111110111#
#1000100000100000101000100010101#
#1110111110101110101111111010101#
#1000001000000010100000000000001#
#1111111111111111111111111y11111#
#################################