###################################
#001111111111111111111111111111111#
#000010000000100010000010000000001#
#101111111110101110111111111011111#
#100000001010000000101000100010101#
#111110111010111110101110111010101#
#101000001000001010001000101000001#
#101111101011101010101011101011111#
#100000001010000010101000100000001#
#1010111110111x1111101110101011101#
#101010101000001010100000101010001#
#101110101010111010101110101110111#
#101000000010000000101010101000001#
#101011111011111010101011111111101#
#101000100010101010101000001010001#
#101010101110101110101010111010111#
#100010100010100000100010000000001#
#111011101110111011101110111010101#
#101010001000000000100010001010101#
#101011111011111011111110101111101#
#100000101000001000001010100010001#
#111011101010111011111010101110111#
#101000100010101010001000100010001#
#101011101011101110101010111111101#
#100010001000000010100010000010001#
#11111y111111111111111111111111110#
###################################