###################################
#11111111111111111111111x111111111#
#100010101010001000100000001000101#
#101110101010101110101111111010101#
#101010100000101000001000000010001#
#101010101111111111101010111010101#
#100000001000001000001010101010101#
#101110111110101111101010101011101#
#101000000000101000000010101000101#
#111110101011101011111011101111101#
#101000101010100000001000001010101#
#101010101010111010111110111010101#
#100010101010000010100000001010001#
#111010111111111110101111111011101#
#100010001000100010101000001000101#
#101111101110101110101011111011101#
#101010100000100000100000101000101#
#111010111011111110111110101010111#
#100000001000101000001000100010101#
#111110111111101111101111111110101#
#101000100000000010001000101010001#
#101011101011101011101110101010111#
#100000001010101010000010000010001#
#101011101110101011101111101010101#
#101010000000101000000000001000101#
#111111111y11111111111111111111111#
###################################