#################################
#1111111111111111111111111111111#
#1000000000100000000010000010001#
#1111111010111x11101110111110111#
#1010001010000010001000100000001#
#1010111110101111111110101111111#
#1000000010100000000010001010001#
#1110111111111111101111101011101#
#1000001000001000001000000000001#
#1011111110111010101011101111111#
#1000000010000010101010000000001#
#1111111011111111101011111011101#
#1000000000100010000000001010001#
#1010111110101111101110101111111#
#1010101000000000000010100010001#
#1010101111101010101010111110111#
#1010001000001010101010101000101#
#1011111010111010111010101110101#
#1000001010101010100010001000001#
#1010101111101010111111111010111#
#1010100010000010001000001010001#
#1110111010111111101010111011101#
#1000001010000010000010000010001#
#11111111111111111111111111111y1#
#################################