#################################
#11111111111111111111111x1111111#
#1000100010101000100000000000001#
#1110101010101010101110111111101#
#1000001000001010000010000000101#
#1111101011101011101110111110101#
#1000101010000010001010000010101#
#1110111111111010111010111111111#
#1000000010001010100000001000101#
#1110111110101110111110111011101#
#1000000000101010100000101000001#
#1011111010111010111010101011111#
#1010001010001000101010001000001#
#1110111010111010101010111011101#
#1000000010001010100010101000101#
#1011111111111011111011101110101#
#1010001000001010000010101000101#
#1010111010111010101010101110101#
#1000000010100010101000100000101#
#1111101110111111111110101010101#
#1000101010000000100010001010101#
#1011101011111011111010101111111#
#1000000010000000000000100000001#
#11111y1111111111111111111111111#
#################################