###################################
#11111x111111111111111111111111111#
#101000000000000010000000100000001#
#101011111011111110111011111011111#
#100000001000101000001000001010101#
#111101111101010111111101110101011#
#101000101000001010101000100000101#
#101110101111111110101110111110101#
#100000001000000000100000000000001#
#111011111110101011101110111111101#
#100010100010101010001010001000001#
#111010111011101111101010111110111#
#100000000000000010101000001000001#
#101011111010101110101111111111111#
#101000001010100000000010000000001#
#101110111110111111111010111111101#
#100010001000001000001010001000001#
#101111111010101111101110111111101#
#101000101010100010001010100000101#
#101110101011111010111010111110111#
#100000100010100010000010001000001#
#111011101110101111101010101110111#
#100010100010000000001010100010001#
#101110111011101011111110101010101#
#100000100000101000000000101000111#
#1y1111111111111111111111111111111#
###################################