#################################
#11111111111111111111x1111111111#
#1000100000100000001010000000001#
#1010111110101110111011101110111#
#1010000010001000000000101010001#
#1110101111111011101111101011101#
#1010100000100010000000001010001#
#1011111110101011101111111010111#
#1000001010001010001010000010001#
#1110101010111011101011111011101#
#1010100000001010000000001000101#
#1011111010101011101110101110111#
#1000000010101010001010101010101#
#1011101111111010101010111010101#
#1000100010001010101000101010001#
#1011111110111011111110101011101#
#1000101000101010000010001000101#
#1110101110101110111010111010101#
#1010001000000010001010100010001#
#1010101110111111101110101111101#
#1000101000001000000000000010001#
#1110111011111110111110101011101#
#1000001000000000001000101000101#
#111111111y111111111111111111111#
#################################