#################################
#11111x1111111111111111111111111#
#1000100000101000100000000010001#
#1010101110101010111011101111101#
#1010000010101010000000100000001#
#1010101011101011111110101111101#
#1010101010000000001000101000001#
#1110111111111011111011111111101#
#1000100000000000100010000010001#
#1011101110101111101111111011101#
#1000001000101000001000100000101#
#1011101111101110111110101110101#
#1000101000100010100000101000001#
#1111101011101110101110111110101#
#1010001000101000001010100000101#
#1010101011111110111011111110111#
#1000101000101010101000100010101#
#1011101011101010101011111010101#
#100010100010y000000010100000101#
#1011111010101010111110111010101#
#1000000010101010100000100010001#
#1011101110101011101011101010111#
#1010001000101000101000001010001#
#1111111111111111111111111111111#
#################################