#################################
#111111111111111111111x111111111#
#1000101010000000000000100000001#
#1010101010111011101011111010111#
#1010000000100000101010000010001#
#1110101010111011101111111110101#
#1000101010100000101000000010101#
#1010111011111110111110111010111#
#1010100000101000000000100000101#
#1011101110101011111110111111101#
#1000101000001000100010000010001#
#1111111011101011111010101010101#
#1000001010001010000000101000101#
#1011111111101111111111101111101#
#1000101010101000001000101010001#
#1110101010101010101011111010111#
#1010001010001010101010000000001#
#1011101010111011111011101110111#
#1000101000000000000000101000001#
#1110101110111011111011111011111#
#1010000000101010000010100000001#
#1011101111101110111110111011101#
#1000000000001000000000001000111#
#11111111111y1111111111111111111#
#################################