###################################
#11111111x111111111111111111111111#
#100000000000000010000000000010001#
#111011101111111111101111111010111#
#100010000010100010001000001010001#
#111111111010101111101111101111101#
#101000100000001000000010001010001#
#101011101010101011101110101011101#
#101000001010100010100010101000101#
#101111101110111110111010101011101#
#100000100010100010000000100010101#
#111110101111101110111110111110101#
#100000101010000010001000100010001#
#101011101010111011101110101011101#
#101010000000001000101000101000001#
#101010101111101010101110101111111#
#101000101000101010100010100010101#
#101111111010111111111011111010101#
#100000001010001010101000000000101#
#111111101110111010101011101010101#
#101000100010100010001010001010001#
#101010111010101110101111101111101#
#100010101000100010100010000010001#
#101110101110111011111010111010111#
#101000000000000000000010100010001#
#1111111111y1111111111111111111111#
###################################